################
#S # #         #
# ## # ##### ###
# #  ### #     #
# # ####   # ###
# # #### # # # #
#   #    # #   #
# ### #### ### #
#   #    # #   F
### #### # #####
#   #    #     #
# ########### ##
#     #     #  #
##### # ### ## #
#       #      #
################